############______ # #################### ####################
[]##[]##[]##........ .................... ...................|
############........ .................... ...................|
[]##[]##[]##........ .................... ...................|
############........ .................... ...................|
#######[@]##........ .................... ...................|
|,,................. .................... ...................|
|,,,................ .................... ...................|
|,,,................ .................... ...................|
|................... .................... ...................|

|................... .................... ...................|
|................... .................... ...................|
|................... .................... ...................|
|................... .................... ...................|
|................... .................... ...................|
|................... .................... ...................|
|................... .................... ...................|
|................... .................... ...................|
|................... .................... ...................|
###############----: #################### ####################